....................................#######..........
....................................#.....#..........
....................................#.....#..........
....................................#.....#..........
....................................#.....#..........
....................................#.....#..........
....................................#.....#..........
....................................#.....#..........
..................................#########..........
..................................#.#................
............................#########................
............................#.....#..................
............................#.....#..................
............................#.....#..................
..........................#########..................
..........................#.#........................
..........................#.#........................
..........................#.#........................
..........................#.###########..............
..........................#...........#..............
#########.##########^.....#.......#########..........
#.......#.#...............#.......#...#...#..........
#.......#.#...............#.......#...#...#..........
#.......#.#...............#.......#...#...#..........
#.......#.#...............#######.#...#...#..........
#.......#.#.....................#.#...#...#..........
###########.....................#.#...#######........
........#.......................#.#.......#.#........
........#######.................#.#.......###########
..............#.................#.#.........#.......#
..............#.........###########.........#.......#
..............#.........#.......#...........#.......#
..............#.........#.......#...........#.......#
..............#.........#.......#...........#.......#
..............#.........#.......###########.#########
..............#.........#.................#..........
..............###########.................#..........
..........................................#..........
....................................#########........
....................................#.....#..........
....................................#.....#..........
....................................#.....#..........
..................................#########..........
..................................#.#................
............................#########................
............................#.....#..................
............................#.....#..................
............................#.....#..................
............................#.....#..................
............................#.....#..................
............................#.....#..................
............................#.....#..................
............................#######..................

